{
  "levels": [
    {
      "name": "The Beginning",
      "grid": [
        [ 0, 0, 0, 0, 0, 0, 0, 0, 0, 0 ],
        [ 0, 1, 1, 1, 1, 1, 1, 1, 1, 0 ],
        [ 0, 1, 0, 0, 0, 0, 0, 0, 1, 0 ],
        [ 0, 1, 0, 1, 1, 1, 1, 0, 1, 0 ],
        [ 0, 1, 0, 1, 0, 0, 1, 0, 1, 0 ],
        [ 0, 1, 2, 1, 0, 0, 1, 5, 1, 0 ],
        [ 0, 1, 0, 1, 0, 0, 1, 0, 1, 0 ],
        [ 0, 1, 0, 1, 1, 1, 1, 0, 1, 0 ],
        [ 0, 1, 6, 0, 0, 0, 0, 0, 1, 0 ],
        [ 0, 1, 1, 1, 1, 1, 1, 1, 1, 0 ]
      ]
    },
    {
      "name": "Key Quest",
      "grid": [
        [ 0, 0, 0, 0, 0, 0, 0, 0, 0, 0 ],
        [ 0, 1, 1, 1, 1, 1, 1, 1, 1, 0 ],
        [ 0, 1, 0, 0, 0, 0, 0, 0, 1, 0 ],
        [ 0, 1, 0, 1, 1, 1, 1, 0, 1, 0 ],
        [ 0, 1, 0, 1, 0, 0, 1, 0, 1, 0 ],
        [ 0, 1, 2, 1, 0, 0, 1, 3, 1, 0 ],
        [ 0, 1, 0, 1, 0, 0, 1, 5, 1, 0 ],
        [ 0, 1, 0, 1, 1, 1, 1, 0, 1, 0 ],
        [ 0, 1, 6, 0, 0, 0, 0, 0, 1, 0 ],
        [ 0, 1, 1, 1, 1, 1, 1, 1, 1, 0 ]
      ]
    },
    {
      "name": "Maze Madness",
      "grid": [
        [ 1, 1, 1, 1, 1, 1, 1, 1, 1, 1 ],
        [ 1, 6, 0, 0, 0, 0, 0, 0, 0, 1 ],
        [ 1, 1, 1, 1, 0, 1, 1, 1, 0, 1 ],
        [ 1, 0, 0, 0, 0, 1, 0, 0, 0, 1 ],
        [ 1, 0, 1, 1, 1, 1, 0, 1, 1, 1 ],
        [ 1, 0, 1, 0, 0, 0, 0, 1, 5, 1 ],
        [ 1, 0, 1, 0, 1, 1, 1, 1, 0, 1 ],
        [ 1, 0, 1, 0, 1, 0, 0, 0, 0, 1 ],
        [ 1, 2, 1, 0, 1, 0, 1, 1, 3, 1 ],
        [ 1, 1, 1, 1, 1, 1, 1, 1, 1, 1 ]
      ]
    },
    {
      "name": "The Labyrinth",
      "grid": [
        [ 6, 0, 0, 0, 1, 1, 1, 1, 1, 1 ],
        [ 1, 1, 1, 0, 1, 0, 0, 0, 0, 1 ],
        [ 1, 0, 1, 0, 1, 0, 1, 1, 0, 1 ],
        [ 1, 0, 1, 0, 1, 0, 1, 0, 0, 1 ],
        [ 1, 0, 1, 0, 1, 0, 1, 1, 1, 1 ],
        [ 1, 0, 1, 0, 0, 0, 0, 0, 0, 1 ],
        [ 1, 0, 1, 1, 1, 1, 1, 1, 0, 1 ],
        [ 1, 0, 1, 0, 0, 0, 0, 0, 5, 1 ],
        [ 1, 0, 2, 0, 0, 0, 0, 1, 1, 1 ],
        [ 1, 1, 3, 0, 0, 0, 1, 1, 1, 1 ]
      ]
    },
    {
      "name": "Final Challenge",
      "grid": [
        [ 0, 0, 0, 0, 1, 1, 1, 1, 1, 1 ],
        [ 1, 6, 0, 0, 1, 0, 0, 0, 0, 1 ],
        [ 1, 1, 1, 0, 1, 0, 1, 1, 0, 1 ],
        [ 1, 0, 0, 0, 1, 0, 1, 0, 0, 1 ],
        [ 1, 0, 1, 1, 1, 0, 1, 1, 1, 1 ],
        [ 1, 0, 1, 0, 0, 0, 0, 0, 5, 1 ],
        [ 1, 0, 1, 0, 1, 1, 1, 1, 0, 1 ],
        [ 1, 0, 1, 0, 1, 0, 0, 0, 0, 1 ],
        [ 1, 0, 2, 0, 1, 0, 1, 1, 3, 1 ],
        [ 1, 1, 1, 1, 1, 1, 1, 1, 1, 1 ]
      ]
    }
  ]
}
